tu tu tu tu tu tu tu tu tu ta ta ta ta ta ta ta ta ta te te te te te te te te te ti ti ti ti ti ti ti ti ti
er er er er er er er er er en en en en en en en en en eu eu eu eu eu eu eu eu eu ei ei ei ei ei ei ei ei ei
it it it it it it it it it ir ir ir ir ir ir ir ir ir in in in in in in in in in ie ie ie ie ie ie ie ie ie
at at at at at at at at at au au au au au au au au au an an an an an an an an an ar ar ar ar ar ar ar ar ar
di di di di di di di di di du du du du du du du du du de de de de de de de de de da da da da da da da da da
re re re re re re re re re ri ri ri ri ri ri ri ri ri ru ru ru ru ru ru ru ru ru ra ra ra ra ra ra ra ra ra
ut ut ut ut ut ut ut ut ut ur ur ur ur ur ur ur ur ur un un un un un un un un un nu nu nu nu nu nu nu nu nu
ne ne ne ne ne ne ne ne ne na na na na na na na na na ni ni ni ni ni ni ni ni ni nd nd nd nd nd nd nd nd nd
eu eu eu eu eu eu eu eu eu ei ei ei ei ei ei ei ei ei er er er er er er er er er en en en en en en en en en
in in in in in in in in in ie ie ie ie ie ie ie ie ie it it it it it it it it it ir ir ir ir ir ir ir ir ir
te te te te te te te te te ti ti ti ti ti ti ti ti ti tu tu tu tu tu tu tu tu tu ta ta ta ta ta ta ta ta ta
ni ni ni ni ni ni ni ni ni nd nd nd nd nd nd nd nd nd ne ne ne ne ne ne ne ne ne na na na na na na na na na
nu nu nu nu nu nu nu nu nu ut ut ut ut ut ut ut ut ut ur ur ur ur ur ur ur ur ur un un un un un un un un un
de de de de de de de de de da da da da da da da da da di di di di di di di di di du du du du du du du du du
ru ru ru ru ru ru ru ru ru ra ra ra ra ra ra ra ra ra re re re re re re re re re ri ri ri ri ri ri ri ri ri
an an an an an an an an an ar ar ar ar ar ar ar ar ar at at at at at at at at at au au au au au au au au au
